"Jahr";"Monat";"Anzahl Arbeitslose - gesamt";"Anzahl Arbeitslose - Frauen";"Anzahl Arbeitslose - 15- bis unter 25 Jahre";"Anzahl Arbeitslose - 55- bis unter 65 Jahre";"Anzahl Arbeitslose- Langzeitarbeitslose";"Anzahl Arbeitslose - Schwerbehinderte";"Anzahl Arbeitslose - Ausländer";"Arbeitslosenanteil - Frauen";"Arbeitslosenanteil - Langzeitarbeitslose";"Arbeitslosenanteil - Ausländer";"ALO-Quote: alle ziv. EP - gesamt";"ALO-Quote: alle ziv. EP - Männer";"ALO-Quote: alle ziv. EP - Frauen";"ALO-Quote: alle ziv. EP - 15- bis unter 25-Jahre";"ALO-Quote: alle ziv. EP - 55- bis unter 65-Jahre";"ALO-Quote: alle ziv. EP - Ausländer";"ALO-Quote: alle abh. ziv. EP - gesamt";"UB: Personen im weiteren Sinne arbeitslos";"UB: Arbeitslosigkeit im weiteren Sinne";"UB: Personen nahe am Arbeitslosenstatus";"UB: Unterbeschäftigung im engeren Sinne";"UB: Personen weit weg vom Arbeitslosenstatus";"UB: Unterbeschäftigung im weiteren Sinne";"Unterbeschäftigungsquote";"Bestand offene Arbeitsstellen"
"2011";"01 ";30392;13447;3495;4905;10476;1239;2076;44;35;7;12;12;11;11;13;21;13;1502;31894;3672;35566;1419;36985;14;2049
"2011";"02 ";30194;13267;3545;4864;10361;1258;2087;44;34;7;12;12;11;12;13;21;13;1573;31767;3495;35262;1387;36649;14;2305
"2011";"03 ";29426;12957;3389;4805;10218;1258;1982;44;35;7;11;12;10;11;13;20;12;1441;30867;3463;34330;1384;35714;13;2405
"2011";"04";28228;12649;3198;4614;10017;1233;1940;45;36;7;11;11;10;10;12;20;12;1470;29698;3767;33465;1409;34874;13;2492
"2011";"05";26773;12102;2898;4489;9785;1220;1893;45;37;7;10;11;10;10;11;18;11;1584;28357;6096;34453;1385;35838;13;2494
"2011";"06";25662;11702;2721;4290;9557;1213;1862;46;37;7;10;10;9;9;11;18;11;1462;27124;6272;33396;1380;34776;13;2520
"2011";"07";26167;12145;3211;4279;9534;1249;1871;46;36;7;10;10;10;11;11;18;11;1448;27615;6148;33763;1358;35121;13;2596
"2011";"08";25926;12141;3368;4269;9418;1207;1784;47;36;7;10;10;10;11;11;17;11;1605;27531;6037;33568;1339;34907;13;2489
"2011";"09";24807;11555;2900;4231;9151;1174;1752;47;37;7;9;10;9;10;11;17;10;1782;26589;5800;32389;1366;33755;13;2524
"2011";"10";24355;11306;2449;4299;9039;1197;1771;46;37;7;9;9;9;8;11;17;10;1840;26195;5591;31786;1361;33147;12;2492
"2011";"11";23761;10814;2196;4298;8928;1177;1714;46;38;7;9;9;9;7;11;17;10;1861;25622;5583;31205;1385;32590;12;2491
"2011";"12";23906;10652;2183;4335;9065;1175;1779;45;38;7;9;10;8;7;11;17;10;1754;25660;5304;30964;1348;32312;12;2297
"2012";"01 ";25938;11406;2459;4596;9314;1224;1864;44;36;7;10;10;9;8;12;18;11;1677;27615;5048;32663;1283;33946;13;2315
"2012";"02 ";26177;11317;2586;4539;9238;1244;1889;43;35;7;10;11;9;8;12;18;11;1629;27806;5261;33067;1254;34321;13;2389
"2012";"03 ";25770;11115;2619;4459;9205;1261;1896;43;36;7;10;11;9;9;11;18;11;1688;27458;5288;32746;1205;33951;13;2493
"2012";"04";25132;11031;2494;4369;9136;1267;1899;44;36;8;9;10;9;8;11;18;11;1703;26835;5351;32186;1078;33264;12;2520
"2012";"05";24136;10758;2303;4277;8999;1233;1809;45;37;8;9;10;8;8;10;17;10;1715;25851;5533;31384;983;32367;12;2604
"2012";"06";23466;10505;2155;4164;8890;1229;1763;45;38;8;9;9;8;7;10;16;10;1818;25284;5717;31001;913;31914;12;2699
"2012";"07";23985;10871;2372;4207;8923;1268;1749;45;37;7;9;9;8;8;10;16;10;1822;25807;5535;31342;1520;32862;12;2571
"2012";"08";24591;11195;2803;4133;9035;1266;1807;46;37;7;9;10;9;10;10;17;10;1884;26475;5360;31835;1417;33252;12;2873
"2012";"09";23682;10704;2477;4103;8942;1198;1864;45;38;8;9;9;8;8;10;17;10;1904;25586;5540;31126;1380;32506;12;2973
"2012";"10";23398;10523;2155;4141;9057;1207;1801;45;39;8;9;9;8;7;10;16;10;1975;25373;5559;30932;1384;32316;12;2786
"2012";"11";23144;10326;2056;4099;8979;1176;1771;45;39;8;9;9;8;7;10;16;10;1957;25101;5725;30826;1424;32250;12;2527
"2012";"12";23831;10405;2042;4286;9025;1211;1830;44;38;8;9;10;8;7;10;17;10;1911;25742;5423;31165;1390;32555;12;2304
"2013";"01 ";26047;11135;2240;4664;9207;1258;2015;43;35;8;10;11;9;8;11;18;11;1803;27850;5081;32931;1277;34208;12;2461
"2013";"02 ";26157;11085;2429;4672;9278;1294;2020;42;36;8;10;11;9;8;11;18;11;1856;28013;5269;33282;1180;34462;13;2496
"2013";"03 ";25841;11019;2445;4634;9186;1261;2045;43;36;8;10;11;9;8;11;19;11;1905;27746;5354;33100;1134;34234;12;2439
"2013";"04";25325;10848;2408;4516;9114;1284;2017;43;36;8;9;10;8;8;11;18;10;1936;27261;5520;32781;1114;33895;12;2365
"2013";"05";24273;10572;2210;4431;8963;1281;1955;44;37;8;9;10;8;8;11;17;10;1989;26262;5410;31672;1141;32813;12;2284
"2013";"06";23521;10326;2046;4372;8769;1283;1919;44;37;8;9;9;8;7;10;17;10;2142;25663;5394;31057;1141;32198;12;2309
"2013";"07";23446;10451;2233;4336;8649;1312;1886;45;37;8;9;9;8;8;10;17;10;2313;25759;5269;31028;1122;32150;11;2335
"2013";"08";24109;10870;2631;4312;8695;1337;1949;45;36;8;9;9;8;9;10;17;10;2239;26348;5111;31459;1172;32631;12;2472
"2013";"09";23521;10614;2311;4274;8623;1323;1960;45;37;8;9;9;8;8;10;17;10;2104;25625;5189;30814;1140;31954;11;2612
"2013";"10";22828;10219;2002;4246;8457;1322;1942;45;37;9;8;9;8;7;10;17;9;2190;25018;5258;30276;1128;31404;11;2593
"2013";"11";22694;10083;1830;4233;8409;1297;1923;44;37;9;8;9;8;6;10;17;9;2120;24814;5160;29974;1138;31112;11;2438
"2013";"12";23105;10116;1817;4363;8514;1311;1993;44;37;9;8;9;8;6;10;18;9;2056;25161;4818;29979;1166;31145;11;2396
"2014";"01 ";24841;10660;1993;4647;8783;1357;2111;43;35;9;9;10;8;7;11;19;10;1941;26782;4661;31443;1153;32596;12;2398
"2014";"02 ";24922;10626;2068;4618;8702;1353;2099;43;35;8;9;10;8;7;11;19;10;1920;26842;4750;31592;1135;32727;12;2550
"2014";"03 ";24640;10590;2037;4582;8728;1355;2077;43;35;8;9;10;8;7;11;19;10;1937;26577;4711;31288;1154;32442;12;2657
"2014";"04";24093;10533;1970;4517;8652;1374;2063;44;36;9;9;9;8;7;11;18;10;1939;26032;4841;30873;1140;32013;11;2598
"2014";"05";23623;10396;1845;4531;8765;1337;2064;44;37;9;8;9;8;7;10;16;9;1813;25436;4719;30155;1153;31308;11;2520
"2014";"06";23091;10245;1751;4500;8629;1316;2025;44;37;9;8;9;8;6;10;16;9;2037;25128;4628;29756;1165;30921;11;2751
"2014";"07";22882;10167;1769;4381;8638;1300;2001;44;38;9;8;9;8;7;16;9;9;2030;24912;4537;29449;1165;30614;11;2970
"2014";"08";23651;10554;2180;4390;8653;1291;2045;45;37;9;8;9;8;8;10;16;9;1939;25590;4270;29860;1160;31020;11;3057
"2014";"09";23020;10283;1893;4349;8490;1291;2076;45;37;9;8;9;8;7;10;16;9;1973;24993;4164;29157;1146;30303;11;3052
"2014";"10";22414;10017;1606;4307;8357;1295;2087;45;37;9;8;8;8;6;10;16;9;2046;24460;4105;28565;1106;29671;10;3106
"2014";"11";21869;9728;1442;4311;8243;1244;2065;45;38;9;8;8;7;5;10;16;9;2167;24036;4118;28154;1080;29234;10;2939
"2014";"12";22255;9744;1472;4456;8278;1275;2085;44;37;9;8;9;7;5;10;16;9;2059;24314;3767;28081;1064;29145;10;2942
"2015";"01 ";24376;10526;1584;4805;8494;1335;2296;43;35;9;9;9;8;6;11;18;10;1980;26356;3290;29646;1010;30656;11;2878
"2015";"02 ";24288;10406;1690;4722;8337;1300;2321;43;34;10;9;9;8;6;11;18;10;2018;26306;3483;29789;989;30778;11;3070
"2015";"03 ";23768;10138;1661;4604;8224;1266;2300;43;35;10;8;9;8;6;11;18;9;1955;25723;3583;29306;971;30277;11;3022
"2015";"04";23151;10025;1637;4463;8243;1256;2311;43;36;10;8;9;8;6;10;18;9;2051;25202;3470;28672;940;29612;10;3127
"2015";"05";22442;9759;1498;4353;8179;1275;2278;44;36;10;8;9;7;6;10;18;9;1953;24395;3666;28061;909;28970;10;3240
"2015";"06";21737;9560;1389;4285;8044;1237;2278;44;37;11;8;8;7;5;10;18;9;1958;23695;3554;27249;879;28128;10;3301
"2015";"07";22300;9830;1661;4270;8131;1224;2273;44;37;10;8;8;7;6;9;18;9;1892;24192;3183;27375;844;28219;10;3402
"2015";"08";22472;10013;1740;4233;8099;1229;2318;45;36;10;8;8;7;7;9;19;9;1864;24336;3003;27339;822;28161;10;3359
"2015";"09";21620;9630;1547;4150;8053;1239;2334;45;37;11;8;8;7;6;9;19;8;1816;23436;3055;26491;772;27263;9;3320
"2015";"10";21435;9480;1341;4134;8110;1222;2359;44;38;11;8;8;7;5;9;19;8;1826;23261;3041;26302;735;27037;9;3575
"2015";"11";21161;9350;1290;4146;8063;1173;2376;44;38;11;7;8;7;5;9;19;8;1843;23004;3078;26082;697;26779;9;3402
"2015";"12";21115;9142;1225;4172;8097;1161;2388;43;38;11;7;8;7;5;9;19;8;1870;22985;3168;26153;653;26806;9;3172
"2016";"01 ";22416;9607;1312;4408;8398;1200;2558;43;38;11;8;9;7;5;10;21;9;1830;24246;3107;27353;276;27629;10;3190
"2016";"02 ";22333;9503;1452;4368;8306;1179;2785;43;37;13;8;9;7;6;10;23;9;1814;24147;3355;27502;285;27787;10;3450
"2016";"03 ";22643;9378;1802;4246;8228;1180;3611;41;36;16;8;9;7;7;9;29;9;1786;24429;3428;27857;288;28145;10;3495
"2016";"04";22137;9202;1810;4156;8185;1118;3734;42;37;17;8;9;7;7;9;30;9;1820;23957;3738;27695;305;28000;10;3444
"2016";"05";21341;8931;1730;4054;7993;1100;3507;42;38;16;7;8;7;7;9;25;8;1871;23212;4072;27284;298;27582;10;3477
"2016";"06";20814;8868;1654;3992;7940;1113;3303;43;38;16;7;8;7;7;9;24;8;1871;22685;4246;26931;305;27236;9;3364
"2016";"07";21331;9110;1888;3989;7882;1107;3314;43;37;16;7;8;7;8;9;24;8;1799;23130;4105;27235;297;27532;9;3166
"2016";"08";20751;8842;1817;3985;7703;1102;3321;43;37;16;7;8;7;8;9;24;8;1922;22673;3982;26655;315;26970;9;3111
"2016";"09";20016;8599;1598;3957;7615;1108;2993;43;38;15;7;8;6;7;9;21;8;1924;21940;4258;26198;309;26507;9;3158
"2016";"10";19655;8513;1414;3913;7471;1121;2965;43;38;15;7;7;6;6;9;21;8;1934;21589;4589;26178;297;26475;9;3154
"2016";"11";19193;8240;1338;3868;7313;1095;2903;43;38;15;7;7;6;6;8;21;7;1906;21099;4751;25850;312;26162;9;2930
"2016";"12";19275;8218;1287;3939;7250;1088;2894;43;38;15;7;7;6;5;9;21;7;1944;21219;4715;25934;292;26226;9;2928
"2017";"01 ";20871;8795;1449;4242;7333;1120;3274;42;35;16;7;8;6;6;9;0;8;1870;22741;4464;27205;293;27498;9;2887
"2017";"02 ";20880;8724;1508;4228;7235;1106;3225;42;35;15;7;8;6;6;9;0;8;1883;22763;4755;27518;283;27801;10;3083
"2017";"03 ";20271;8508;1510;4099;7163;1082;3219;42;35;16;7;8;6;6;9;0;8;1910;22181;4956;27137;290;27427;9;3077
"2017";"04";19507;8293;1411;3962;7050;1069;3034;43;36;16;7;8;6;6;9;0;8;1935;21442;5336;26778;300;27078;9;3026
"2017";"05";18789;8080;1383;3880;6923;1053;3032;43;37;16;7;7;6;6;8;0;7;1975;20764;5416;26180;298;26478;9;3160
"2017";"06";18704;8045;1416;3881;6893;1039;3112;43;37;17;7;7;6;6;8;0;7;1887;20591;5319;25910;310;26220;9;3215
"2017";"07";19444;8406;1807;3903;6859;1111;3241;43;35;17;7;7;6;8;8;0;7;1850;21294;5101;26395;302;26697;9;3427
"2017";"08";18695;8026;1708;3790;6732;1080;3152;43;36;17;7;7;6;7;8;0;7;1870;20565;5139;25704;299;26003;9;3531
"2017";"09";18292;7810;1685;3751;6600;1050;3187;43;36;17;6;7;6;7;8;0;7;1885;20177;5301;25478;290;25768;9;3597
"2017";"10";18029;7618;1509;3668;6469;1037;3308;42;36;18;6;7;6;7;8;0;7;1883;19912;5172;25084;274;25358;9;3718
"2017";"11";17684;7479;1447;3675;6380;1032;3130;42;36;18;6;7;6;6;8;0;7;1842;19526;5390;24916;259;25175;9;3610
"2017";"12";17720;7400;1437;3751;6214;1038;3114;42;35;18;6;7;5;6;8;0;7;1833;19553;5349;24902;248;25150;9;3956
"2018";"01 ";19115;7877;1519;4072;6324;1103;3439;41;33;18;7;7;6;7;9;0;7;1757;20872;5084;25956;238;26194;9;3910
"2018";"02 ";18838;7739;1566;4022;6297;1083;3438;41;33;18;7;7;6;7;9;0;7;1734;20572;5231;25803;250;26053;9;4214
"2018";"03 ";18548;7520;1542;3982;6207;1048;3442;41;34;19;6;7;6;7;9;0;7;1674;20222;5203;25425;242;25667;9;4385
"2018";"04";18211;7461;1470;1470;6151;1019;3474;41;34;19;6;7;6;6;8;0;7;1663;19874;5086;24960;250;25210;9;4456
"2018";"05";17662;7223;1430;3779;6038;1055;3353;41;34;19;6;7;5;6;8;0;7;1618;19280;5116;24396;260;24656;8;4417
"2018";"06";17534;10203;1454;3747;6019;1045;3446;42;34;20;6;7;5;6;8;0;7;1530;19064;4869;23933;263;24196;8;4197
"2018";"07";18198;7603;1830;3729;5969;1031;3715;42;33;20;6;7;6;7;8;0;7;1587;19785;4509;24294;254;24548;8;4212
"2018";"08";17816;7435;1761;3703;5896;1027;3735;42;33;21;6;7;5;7;8;0;7;1550;19366;4556;23922;266;24188;8;4196
"2018";"09";17132;7135;1704;3596;5644;1009;3629;42;33;21;6;6;5;7;7;0;6;1564;18696;4739;23435;264;23699;8;4246
"2018";"10";17022;7121;1521;3620;5635;1018;3568;42;33;21;6;6;5;6;7;0;6;1528;18550;4811;23361;268;23629;8;4137
"2018";"11";16516;6849;1431;3632;5526;983;3484;42;34;21;6;6;5;6;7;0;6;1641;18157;4867;23024;277;23301;8;3842
"2018";"12";16515;6767;1406;3604;5470;999;3545;41;33;22;6;6;5;6;7;0;6;1693;18208;4812;23020;255;23275;8;3510
"2019";"01 ";17677;7206;1478;3898;5590;1047;3740;41;32;21;6;7;5;6;8;0;7;1624;19301;4555;23856;257;24113;8;3353
"2019";"02 ";17743;7127;1577;3854;5525;1101;3840;40;31;22;6;7;5;6;8;0;7;1607;19350;4540;23890;264;24154;8;3405
"2019";"03 ";17313;6982;1545;3788;5445;1068;3826;40;32;22;6;7;5;6;8;0;7;1590;18903;4568;23471;257;23728;8;3443
"2019";"04";16894;6889;1511;3678;5372;1063;3738;41;32;22;6;6;5;6;8;0;6;1654;18548;4815;23363;242;23605;8;3641
"2019";"05";16876;6957;1477;3620;5363;1050;3788;41;32;22;6;6;5;6;7;0;6;1667;18543;4761;23304;255;23559;8;3868
"2019";"06";16562;6879;1454;3553;5246;1021;3670;42;32;22;6;6;5;5;7;0;6;1697;18259;4664;22923;254;23177;8;4027
"2019";"07";16955;7177;1662;3533;5207;1085;3729;42;31;22;6;6;5;6;7;0;6;1821;18776;4517;23293;242;23535;8;4088
"2019";"08";17184;7317;1775;3621;5175;1111;3752;43;30;22;6;6;5;7;7;0;6;1816;19000;4306;23306;234;23540;8;4170
"2019";"09";16479;6950;1650;3581;5136;1074;3633;42;31;22;6;6;5;6;7;0;6;1802;18281;4438;22719;220;22939;8;4287
